1111111111111
10011E00P00C1
1110011111101
1C00000000001
1111111111111