1111111111111111111111111111
1P00010X000100001000000001E1
11CC000000110000CC000C000101
1110000000010000000000000001
1C0000000000CCC0000000100001
1111111111111111111111111111