1111111111111111111111111111
1P00000X00010000100000E00001
11CC000000010000CC000C000001
1110000000010000000000000001
1C0000000000CCC0000000100001
1111111111111111111111111111